500
7,7
PA,WA,PA,PA,PA,WT,PA
IC,WA,PA,WA,B1,WT,PA
IC,WA,PA,WA,WA,WT,WT
SW,IC,PA,PA,PA,PA,PA
WA,WA,PA,T1,PA,PA,PA
PA,PA,PA,PA,WA,WA,C2
PA,PA,PA,PA,BL,PA,EX
II,II,II,II,II,II,CN
II,II,II,II,II,II,II
II,II,II,II,II,II,II
II,II,II,BN,II,II,II
II,II,II,II,II,II,II
II,II,II,II,II,II,II
CN,II,II,II,II,II,II
PY,##,##,BC,##,##,##
##,##,##,##,##,##,BC
##,##,##,##,##,##,##
##,##,##,##,##,##,##
##,##,##,##,##,##,##
##,FG,##,##,##,##,##
##,##,##,##,##,##,##
